[Lesson-1]
arched : дугой (брови) : [ ɑːtʃt ] [арчд]
attractive : привлекательный : [ əˈtræktɪv ] [эттрактив]
bald : лысый : [ bɔːld ] [болд]
bald patch : лысина : [ bɔːld pætʃ ] [болд пэтч]
beard : борода : [ bɪəd ] [бирд]
beautiful, lovely, pretty : красивый (о женщине или ребенке) : 	[ ˈbjuːtəfl̩ ] [бьютифул] [ ˈlʌvli ] [лавли] [ ˈprɪti ] [прити]
beauty : красота : [ ˈbjuːti ] [бьюти]
big / great toe : большой палец (на ноге) : [ bɪɡ ] [биг] [ ˈɡreɪt təʊ ] [грейт тоу]
breast : грудь : [ brest ] [брест]
broad forehead : широкий лоб : [ brɔːd ˈfɒrɪd ] [брод фохед]
brows : брови : [ braʊz ] [браус]
bushy : густые (о бровях) : [ ˈbʊʃi ] [бущи]
chin : подбородок : [ tʃɪn ] [чин]
close-set eyes : близко посаженные глаза : [ ˈkləʊs set aɪz ] [клоуз-сет айс]
common : обычный : [ ˈkɒmən ]  [камэн]
complexion : цвет лица : [ kəmˈplekʃn̩ ] [комплекшн]
cropped head : стриженная голова : [ krɒpt hed ] [кропт хед]
curly hair : кудрявые волосы :  [ ˈkɜːli heə ] [кёрли хеа]
deep-set eyes : глубоко посаженные глаза : [ diːp set aɪz ] [дип-сейт айс]
dimples : ямочки (на щеках) : [ ˈdɪmpl̩z ] [димплес]
dull glance : тусклый взгляд : [ dʌl ɡlɑːns ] [дал глэнс]
ear : ухо : [ ɪə ] [иэ]
elbow : локоть : [ ˈelbəʊ ] [элбоу]
face : лицо : [ feɪs ] [фэйс]
fair hair : белокурые волосы : [ feə heə ] [феа хеа]
fat : толстый : [ fæt ] [фэт]
figure : фигура : [ ˈfɪɡə ] [фигьюэ]
finger : палец (на руке) : [ ˈfɪŋɡə ] [фингэ]
first tooth : молочный зуб : [ ˈfɜːst tuːθ ] [ фёрст тюф]
flush : румянец : [ flʌʃ ] [флаш]
foot : ступня : [ fʊt ] [фут]
fresh : свежий : [ freʃ ] [фреш]
glassy eyes : тусклые глаза : [ ˈɡlɑːsi aɪz ] [глэси айс]
good-looking, handsome : красивый (о мужчине) : [ ɡʊd ˈlʊkɪŋ ] [гуд-лукин] [ ˈhænsəm ] [хенсом]
slim : худой (в спортивной форме) : [slɪm] [слим]
thin : худощавый (тонкий, худой) : [θɪn] [фин]
